1 1 1 1 1 1 1 1 1 1 1 1 1 1 1 1 1 1 1 1 1 1 1 1 1 1 1 1 1 1 1
1 8 4 3 4 8 1 1 1 8 4 3 4 8 1 1 1 8 4 3 4 8 1 1 1 8 4 3 4 8 1
1 1 1 0 1 1 1 1 1 1 1 0 1 1 1 1 1 1 1 0 1 1 1 1 1 1 1 0 1 1 1
1 1 1 3 0 0 0 3 0 0 0 3 1 1 1 1 1 1 1 3 0 0 0 3 0 0 0 3 1 1 1
1 1 1 0 1 1 1 0 1 1 1 0 1 1 1 1 1 1 1 0 1 1 1 0 1 1 1 0 1 1 1
1 8 4 3 4 8 1 0 1 8 4 3 4 8 1 1 1 8 4 3 4 8 1 0 1 8 4 3 4 8 1
1 1 1 1 1 1 1 0 1 1 1 1 1 1 1 1 1 1 1 1 1 1 1 0 1 1 1 1 1 1 1
1 1 1 1 1 1 1 3 0 0 0 0 0 0 0 3 0 0 0 0 0 0 0 3 1 1 1 1 1 1 1
1 1 1 1 1 1 1 0 1 1 1 1 1 1 1 0 1 1 1 1 1 1 1 0 1 1 1 1 1 1 1
1 8 4 3 4 8 1 0 1 8 4 3 4 8 1 0 1 8 4 3 4 8 1 0 1 8 4 3 4 8 1
1 1 1 0 1 1 1 0 1 1 1 0 1 1 1 0 1 1 1 0 1 1 1 0 1 1 1 0 1 1 1
1 1 1 3 0 0 0 3 0 0 0 3 1 1 1 0 1 1 1 3 0 0 0 3 0 0 0 3 1 1 1
1 1 1 0 1 1 1 1 1 1 1 0 1 1 1 0 1 1 1 0 1 1 1 1 1 1 1 0 1 1 1
1 8 4 3 4 8 1 1 1 8 4 3 4 8 1 0 1 8 4 3 4 8 1 1 1 8 4 3 8 5 1
1 1 1 1 1 1 1 1 1 1 1 1 1 1 1 0 1 1 1 1 1 1 1 1 1 1 1 1 1 1 1
2 9 9 9 0 0 0 0 0 0 0 0 0 0 0 3 1 1 1 1 1 1 1 1 1 1 1 1 1 1 1
1 1 1 1 1 1 1 1 1 1 1 1 1 1 1 0 1 1 1 1 1 1 1 1 1 1 1 1 1 1 1
1 8 4 3 4 8 1 1 1 8 4 3 4 8 1 0 1 8 4 3 4 8 1 1 1 8 4 3 4 8 1
1 1 1 0 1 1 1 1 1 1 1 0 1 1 1 0 1 1 1 0 1 1 1 1 1 1 1 0 1 1 1
1 1 1 3 0 0 0 3 0 0 0 3 1 1 1 0 1 1 1 3 0 0 0 3 0 0 0 3 1 1 1
1 1 1 0 1 1 1 0 1 1 1 0 1 1 1 0 1 1 1 0 1 1 1 0 1 1 1 0 1 1 1
1 8 4 3 4 8 1 0 1 8 4 3 4 8 1 0 1 8 4 3 4 8 1 0 1 8 4 3 4 8 1
1 1 1 1 1 1 1 0 1 1 1 1 1 1 1 0 1 1 1 1 1 1 1 0 1 1 1 1 1 1 1
1 1 1 1 1 1 1 3 0 0 0 0 0 0 0 3 0 0 0 0 0 0 0 3 1 1 1 1 1 1 1
1 1 1 1 1 1 1 0 1 1 1 1 1 1 1 1 1 1 1 1 1 1 1 0 1 1 1 1 1 1 1
1 8 4 3 4 8 1 0 1 8 4 3 4 8 1 1 1 8 4 3 4 8 1 0 1 8 4 3 4 8 1
1 1 1 0 1 1 1 0 1 1 1 0 1 1 1 1 1 1 1 0 1 1 1 0 1 1 1 0 1 1 1
1 1 1 3 0 0 0 3 0 0 0 3 1 1 1 1 1 1 1 3 0 0 0 3 0 0 0 3 1 1 1
1 1 1 0 1 1 1 1 1 1 1 0 1 1 1 1 1 1 1 0 1 1 1 1 1 1 1 0 1 1 1
1 8 4 3 4 8 1 1 1 8 4 3 4 8 1 1 1 8 4 3 4 8 1 1 1 8 4 3 4 8 1
1 1 1 1 1 1 1 1 1 1 1 1 1 1 1 1 1 1 1 1 1 1 1 1 1 1 1 1 1 1 1